10x10
2, 2
1.57
..........
..........
..........
..........
..........
..........
..........
..........
x........x
xx......xx